data	true_label	pre_label
揭秘曹景伟：曾跟韦迪拍过桌子获赞“搞训练奇才”	体育	娱乐
苏东：英德形势很危险澳大利亚绝不会束手就擒	体育	时政
做手术新编节目困难多文婷姐妹预赛第三真不易	体育	娱乐
郭艾伦思想“溜号”遭叔叔数落郭帅大训侄子(图)	体育	娱乐
14岁男生一箭射死同学两个花季少年人生被改写	体育	社会
陈若琳笑谈与周杰伦第一次亲密接触期待实现大满贯	体育	娱乐
李元伟的201037万字自传掀风暴他揭开多少秘密	体育	娱乐
体操神童被虐案落定疲惫母亲100辈子也不练体育	体育	社会
奥运电影刘翔领衔重量级群星规模超过张艺谋大片	体育	娱乐
朴智星百场盛典疑似告别演出法新社：世界的损失	体育	娱乐
伊拉克两名田径选手将参加北京奥运会	体育	时政
现代快报：别让光棍们郁闷	体育	游戏
拓展训练发生重大悲剧攀岩墙坍塌20名师生5死5伤	体育	社会
体育总局人员说明情况前战友认可田亮出演雷锋	体育	时政
王冰玉揭秘无名指戒指来源清唱暖暖可媲美梁静茹	体育	娱乐
秦天：比萨斜塔倒了	体育	时政
福原爱绯闻“麻辣烫”一首歌乐翻中国男队(图)	体育	娱乐
北京火炬传递限行方案公布详解传递路线及管制	体育	时政
济宁公安微博回应刘华娜父母车祸澄清不立案说法	体育	社会
奇闻！表情受挫也会被罚款状元秀为此事掏了50元	体育	教育
李玮锋现场模仿李连杰独门武术抱怨没和偶像合影	体育	娱乐
蔡斌：意志品质不能有问题将重点解决两个环节	体育	时政
美利坚导演格林童话霍华德让英格兰无解无愧最佳	体育	娱乐
陈冠希发微博力挺勒布朗：golebrongo!!!(图)	体育	娱乐
总局说明崔大林协查情况主管领导说明情况未涉案	体育	时政
自由市场top15之控卫小牛精灵扬名黑豆苦寻先发	体育	财经
杰拉德差点让奥巴马输啤酒格林帮美总统挽回颜面	体育	时政
日本新华侨报：国奥给华人球迷当头棒喝	体育	时政
新疆队错失冠军赢得票房赛季门票总收入超1600万	体育	娱乐
韩鹏爱妻曾做兼职模特一个月奖金博美人一笑(组图)	体育	家居
李佳薇从未接受该媒体采访与李厚霖无任何联系	体育	娱乐
伦敦受金融风暴影响英媒：2012年还是北京办吧	体育	教育
“台湾辣妈”网上征婚数十万网友点击咨询(图)	娱乐	教育
瑞莎亲手上菜与电玩玩家共享情人节大餐	娱乐	游戏
胡瓜前妻圣诞染病没儿陪孤单夜市算命(图)(3)	娱乐	家居
多位数减法	娱乐	家居
波兰斯基受害者请求撤销控诉被法庭拒绝(图)	娱乐	时政
周冬雨北电初试添堵全程受媒体粉丝追捧(图)	娱乐	教育
北影报名现场人潮汹涌俊男靓女有所减少(图)	娱乐	教育
美国78岁老牌影星瑞普-托恩烂醉持枪闯银行被捕	娱乐	时政
骗走孟广美千万的男人被判无罪	娱乐	社会
台湾音乐人不雅照及视频外泄被敲诈	娱乐	社会
马艳丽参加黄帝故里大典祭拜先祖	娱乐	社会
隐世活字雕刻师首度访港即兴刻木活字挥春(图)	娱乐	时政
soler欠债505万被查账户银行只有500元	娱乐	财经
郭台铭妻子曾馨莹一天吃9顿催奶(图)	娱乐	时政
亚视新闻部前记者被控公车猥亵现已离职	娱乐	社会
羽翘任调酒师评委豪饮24杯鸡尾酒面不改色(图)	娱乐	体育
国际梦研究主席：解析《盗梦空间》的科学依据	娱乐	游戏
十大外星入侵好莱坞版地球防御指南(组图)	娱乐	科技
lucas一岁谢霆锋全家福曝光(组图)	娱乐	家居
精品购物指南：童心是门大生意装嫩制造生产力	娱乐	家居
组合square出席活动宣传环保理念(图)	娱乐	家居
阿桑举行追思会亲友为其送别	娱乐	时政
重新聚焦：艳照门明星复出路线(6)	娱乐	家居
英媒体用众明星最性感部位组合成邦德女郎(图)	娱乐	科技
陈振聪惊讶龚将事业交给他没想到她爱我这么深	娱乐	体育
网评刘孜跨界最有影响推动设计界行业发展(图)	娱乐	家居
知名战地记者利比亚遇袭身亡曾获奥斯卡提名	娱乐	时政
港媒称金庸主动申请加入作协可能任名誉副主席	娱乐	时政
央视名嘴赵普再打维权官司成业主维权带头大哥	娱乐	社会
罗伯特麦基开通微博自录视频透露其中国行计划	娱乐	股票
58岁郭台铭老来得女取名纪念亡妻	娱乐	社会
方中信无锡打赢肖像权官司	娱乐	财经
三星smarttv首获智能五星级评价	家居	科技
王牌久盛终结暴利	家居	财经
林嘉欣确认退出娱乐圈或赴国外学建筑(4)	家居	娱乐
史泰龙带领演员们进行了一次彻底回归	家居	娱乐
马可波罗磁砖3g石代来了！	家居	游戏
世界需求仍高中国光伏市场继续等待开启	家居	教育
万和电气登陆深交所顺德上市企业添新军	家居	股票
李文华：消费者投资黄花梨比较适合	家居	财经
组图：世界十大顶级建筑中国占了二分之一	家居	教育
盖伊里奇在英国购置了1200英亩的房产(图)	家居	时政
杨智深：旅行是认识这个世界多一点的一种方式	家居	教育
幼儿教育呼唤爸爸的加入	家居	教育
自采主材易遭“回扣”潜规则	家居	教育
王艳北京豪宅照片曝光毗邻紫禁城价值上亿(图)	家居	财经
崔华峰：猫气死了文化还在	家居	财经
美国工程师用废纸建房子屹立88年不倒	家居	科技
迷失衣帽间参观好莱坞女星华丽大衣橱	家居	娱乐
小沈阳“笑”果非凡顶固乐满羊城	家居	娱乐
洋超市难以为继乐华梅兰北京大郊亭店关门歇业	家居	股票
2006年4月正式到日本发展(图)	家居	教育
日本运行世界首辆太阳能电池公交车	家居	科技
享家的故事抢iphone手机瑞宝壁纸新浪微博	家居	科技
我集团与民族证券公司正式建立合作关系	家居	时政
2010年青岛北方展即将盛大开幕(2)	家居	游戏
爱茉莉mh006活性印花全面四件套	家居	科技
电工走进社区免费维修电路临时插座终于换了	家居	社会
三楼分别以陈诚的长子、次子、夫人来命名	家居	时政
《战国》曝光新版预告片浴血激战一触即发	家居	娱乐
领头象的可持续发展之路：圣象三征达沃斯启示	家居	体育
东北缺角不利男子(图)	家居	社会
梁洛施将携三子入主香港豪宅花1.2亿8年建成	家居	娱乐
一对龙凤胎预定在感恩节来报到(图)	家居	社会
海南黄花梨疯狂涨价1公斤可兑换40克黄金	家居	财经
红木被泡拍卖公司索赔10万	家居	社会
国家半导体财测均优：单季增12%	家居	股票
饰品利润可达500%？暴利现象令人震惊	家居	财经
1+1设计师沙龙第三期：艺术与设计大师的跨界	家居	教育
高文安：中西合璧营造文化品味生活(组图)	家居	教育
建设公司将空间规划为办公环境(图)	家居	社会
香港法院下月提讯黄光裕国美称未被通知作证	家居	时政
《浙商》杂志采访久盛张恩玖畅谈参会感想	家居	娱乐
林熙蕾与富商马尔代夫闪电结婚	家居	娱乐
醴陵瓷再现神采95年前已获金奖	家居	财经
方文山说来到他家里就好像出国旅游(图)	家居	娱乐
范玮琪订婚豪宅陪嫁	家居	娱乐
半导体照明：芯片国产化比例将达七成	家居	股票
奥斯卡最佳男主角奖(图)	家居	娱乐
沁园省钱大放送乐淘国庆新品机	家居	科技
蒋介石送给英女皇的其他礼物(图)	家居	时政
王力宏家徒四壁	家居	娱乐
地球卫士“石头纸”再度亮相全国“两会”	家居	科技
陶氏、杜邦跻身《财富》500强前百名	家居	时政
建材板块：水泥个股存在补涨机会	家居	股票
卡布丽缇老板表态周三与媒体“面对面”	家居	娱乐
人民日报驳东莞企业倒闭潮说法	家居	时政
卫生部国际健康生活方式博览会公众评选活动	家居	时政
他的黑人父亲完成在英国的学业(图)	家居	教育
应对金融危机消费券能否撬动大买卖	家居	财经
十里河特色街命名八年实现跨越式发展	家居	社会
专家支招选购“孩子天堂”技巧	家居	游戏
《大长今》中的“御膳房”古色古香(图)	家居	娱乐
贾庆林主席会见中华厂商会访京团(组图)	家居	时政
开春选新风：森德专家支你几招	家居	教育
三星半导体厂自查是否具有致癌风险	家居	科技
老总必看：电子镇流器和变压器设计	家居	教育
今顶天衣无缝系列尊荣上市全球守望	家居	游戏
赵本山曾借150万给徒弟小沈阳够豪宅(图)	家居	娱乐
探秘美国总统奥巴马的空军一号(组图)	家居	教育
除身份显赫外李兆会年仅29岁(图)	家居	娱乐
被指甲醛超标红苹果叫板湖南工商局	家居	科技
中国网球公开赛选择了业之峰你选择谁	家居	游戏
德化：工业瓷都欲转向文化瓷都	家居	股票
成霖高宝专注健康时尚生活	家居	娱乐
日本帅哥的御宅曝光图	家居	游戏
潘石屹联手箭牌捐建15所学校卫生间竣工	家居	社会
盘点世界上创意骇人的餐厅(组图)	家居	教育
中国馆闭幕后将成文化博物馆	家居	时政
小s幸福的一家三口	家居	娱乐
汪小菲完婚张雨绮豪门梦碎疑似新欢曝光	家居	娱乐
鸣仁秦齐：扩大影响力拓展大平台(图)	家居	娱乐
香港家协理事会考察团顺利考察敏华控股	家居	时政
张恩玖获中国经济年度人物媒体推荐候选人提名	家居	娱乐
台湾高校启动招收大陆生工作就读期间不得打工	教育	时政
美科学家进行千人实验称人类或许能预知未来	教育	科技
香港中文大学2月19日举办校园游	教育	时政
张素雅机会总在你不经意的时候来到	教育	娱乐
美国9岁超模痴迷中国文化爱学文言文	教育	社会
教育部紧急通知：确保不让一个孩子因灾失学	教育	时政
华裔博士弃高薪儿童游乐业闯出名堂(图)	教育	社会
科学家预测2100年生活人和机器将融合	教育	科技
教育部：2009年研究生考试涉嫌泄题报道失实	教育	时政
意专家称蒙娜丽莎原型或是达芬奇同性恋人(图)	教育	科技
考古证明人类大脑在变小3万年缩水20%	教育	科技
美国将评出2011财政年度奖金获奖者	教育	时政
国内首位聋人新闻主播：无声世界奏响华彩乐章	教育	社会
人民日报：美国大学生拖欠贷款人数逐年上涨	教育	时政
遭遇打包贱卖落榜生信息成“唐僧肉”	教育	社会
伍兹与妻子正式离婚六年完美婚姻终结(图)	教育	娱乐
网友热议北京理科状元遭美国名校拒录	教育	社会
盛大林：从民族造假到国籍造假升级	教育	游戏
高考生模仿《长恨歌》《离骚》写作文	教育	社会
教育部通报一起涉嫌虚假招生宣传案件	教育	时政
大一女生开学报到带上百斤行李17双鞋雷倒同学	教育	社会
fbi探员内部考试时作弊22人被发现	教育	时政
新生注册年龄不属实14岁神童实为17岁	教育	社会
交警协助考生应对意外巡警数次飞车送准考证	教育	社会
高考后放松同学聚会男生喝酒喝到肝破裂	教育	社会
媒体称已证实张孟苏被新加坡私立学院预录	教育	时政
高考移民诉教育部门案：文件虽打架学生仍败诉	教育	社会
华恒教育：发改委合作中心下属机构	教育	股票
英国威廉王子通过微博发布订婚仪式	教育	时政
旅西侨胞婚恋骗局层出不穷闪婚闪孕引祸端	教育	社会
施瓦辛格与妻子分手准备重返好莱坞(图)	教育	娱乐
高中生沉溺网络遭退学后悔莫及请求上学机会	教育	社会
昔日高考状元大学退学街头捡垃圾(图)	教育	社会
的姐开夜车15年支撑女儿上学	教育	社会
iphone收家中遭窃影像华裔工程师高科技擒贼	教育	科技
男生三度高分弃读只因向往北大清华	教育	社会
高校挥舞支票吸引状元网友批某些状元贪图名利	教育	社会
英国新王妃表示愿专心做一名家庭主妇(图)	教育	时政
英国知名企业被爆压榨实习生工作数月无报酬	教育	时政
女孩跨专业留英学翻译获选入联合国做同传	教育	社会
留学生3年3次回国治心病常去赌场妓院(图)	教育	社会
奇迹：受精卵冷冻11年仍能造婴儿(组图)	教育	科技
老校长连收三封大学录取通知书	教育	社会
购新机纪念乔布斯iphone4s纽约热销华裔成主力	教育	科技
25岁女华人金矿工程师年薪百万(图)	教育	社会
15岁女神童未参加高考被香港科技大学破格录取	教育	社会
荷兰人发明别样航拍让风筝带相机去摄影(组图)	教育	科技
抗震小英雄感动考官上清华(图)	教育	社会
大马非法外劳漂白计划实施一周逾24万人登记	教育	时政
美国一男子“以牙还牙”将警犬咬伤	教育	社会
美国18岁中学生当选镇长在学校不爱出风头	教育	社会
昔日学生沉迷网游被迫退学领悟真知考回母校	教育	社会
台有限制承认大陆学历及开放大陆学生赴台就读	教育	时政
高考627分被改成295分续：担心父母健康撒谎	教育	社会
马来西亚开辟“女士专属公车”交通高峰期运行	教育	时政
中国女留学生在澳大利亚遇害身亡	教育	社会
17名楚才入选奥赛国家集训队均被名校预录	教育	社会
泰国少女18岁高2.08米创吉尼斯纪录(图)	教育	社会
教育部规定民办高校换校长须上报核准	教育	时政
香港科技大学计划招收内地生150人	教育	时政
大一新生雇钟点工洗衣服部分90后缺少动手能力	教育	社会
好莱坞十大童星富豪排行之丹尼尔等(组图)	教育	娱乐
女生高考前日被拖拉机撞断腿坚强面对明年再战	教育	社会
全国总工会建议试点学生在父母务工地参加高考	教育	时政
领袖玩微博：奥巴马最受宠萨科齐人缘最差	教育	时政
出租车爱心车队为考生排忧凭准考证免费乘坐	教育	社会
对话英国前卫建筑设计师马克-戴萨姆	教育	家居
汶川抗震小英雄保送上中国地大	教育	社会
法加强对旅客边检外交部提醒赴法请备齐材料	教育	时政
女生被人冒名念大学假学生求情“别讨说法”	教育	社会
大学生花费三万元赴美打洋工(图)	教育	社会
香港中文大学欲落户深圳实行合作办学	教育	时政
专家称考生为参加艺考花费10万不值(图)	教育	社会
杨雅晴索吻是崇洋媚外还是自我追求(图)	教育	娱乐
巴西学生疑遭6名土著杀害后烹食	时政	社会
研究称海平面上升超过预期可能影响数亿人	时政	科技
拜登称美国经济刺激计划不可能立竿见影	时政	股票
法德重申支持欧盟能源气候一揽子计划	时政	股票
教育部称高考是否改期将先由专家调研	时政	教育
加州预算吃紧政府裁员两万	时政	股票
解密文件披露英国调查神秘棱形ufo内幕	时政	科技
美欧日多家大公司同时宣布大规模裁员	时政	股票
外籍青年涉嫌在香港连环杀害3名卖淫女	时政	社会
国家开发银行20天完成600亿元扩大内需增贷计划	时政	财经
文物局谈圆明园铜像拍卖：佳士得应承担后果	时政	财经
两部委通知取消高校招生入学体检乙肝项目检测	时政	教育
英国外交部因英镑贬值陷入财务窘境	时政	股票
广电总局发言人谈名著重拍反对调侃歪曲经典	时政	娱乐
教育部否认mba将招收应届本科生	时政	教育
太空专家设想在太空垃圾碎片上绑气球	时政	科技
教育部透露文理是否分科有望八月敲定	时政	教育
巴西将向国际货币基金组织注资	时政	股票
欧洲阿丽亚娜火箭一箭双星发射成功	时政	科技
俄罗斯拟下调原油出口关税	时政	股票
分析称卫星相撞事件可能影响美太空政策及预算	时政	股票
台湾商人疑遭他人毒手在南非惨死家中	时政	社会
德国智库称德不需要美国式银行拯救计划	时政	股票
美科学家证实爱情可以维持永恒	时政	科技
我国重型巨型运载火箭研制列入发展规划(图)	时政	科技
连战次子连胜武周日完婚婚纱照提前曝光(组图)	时政	娱乐
扔鞋砸布什游戏风靡网络	时政	游戏
瑞典使用直升机营救濒危甲虫(图)	时政	科技
欧盟正式批准瑞士下月加入申根区	时政	股票
奥巴马反对只购买美国货条款	时政	股票
美能源部长朱棣文清华演讲杨振宁夫妇旁听	时政	教育
3名越南男子锯断旧炮弹时被炸死	时政	社会
台湾密宗大师林云过世弟子争遗产	时政	社会
英国1岁女童接受手术移植牛血管	时政	社会
中国国开行与赞比亚发展银行签署合作协议	时政	财经
美国国会通过4100亿美元政府支出法案	时政	股票
香港男子疑因退款问题与职员争执纵火	时政	社会
威廉王子12年首谈戴妃：从未终止对其思念(图)	时政	教育
奥巴马呼吁迅速通过经济刺激计划	时政	股票
印度男孩跨种姓求爱遭虐打后被抛到火车下碾死	时政	社会
研究称蚂蚁能像人类一样交谈	时政	科技
英国男子利用镜子完成自我心理催眠	时政	社会
调查显示日本一半博士找不到工作	时政	教育
江苏惠山古镇修复工程拆迁赶走原住民开酒店	时政	社会
希腊将向保加利亚供应天然气	时政	股票
台军少校涉嫌偷子弹转卖黑道	时政	社会
教育部将启动接收美国10万名学生来华留学方案	时政	教育
韩国强奸犯父母因管教之过被罚重款	时政	社会
奥巴马将召开记者会解释经济策略	时政	股票
奥巴马团队将提交逾6000亿美元经济刺激计划	时政	股票
李敖之子李戡今日入学北大最想听林毅夫课(图)	时政	教育
核工业集团公司原总经理党组书记康日新被双开	时政	社会
科学家预言：本世纪末地球只剩10亿人	时政	科技
加拿大男子乘飞机时从7000米高空跳下	时政	社会
美财政部报告称中国没有操纵人民币汇率	时政	股票
张德江赴江苏调研中小企业发展	时政	家居
报告称欧盟议员5年任期可诈领百万欧元灰色收入	时政	股票
四部门发文规范国际机构人民币债券业务	时政	财经
法德寄望伦敦峰会重建全球金融秩序	时政	股票
微软前研发专家西蒙尼将乘俄飞船再游太空	时政	科技
军事博物馆永久收藏神舟七号搭载中国地图	时政	科技
教育部：报考学术硕士考生可改读专业硕士	时政	教育
山东宁夏将开展建材下乡试点工作	时政	家居
奥巴马将会晤国会领导人商讨经济方案	时政	股票
两岸实现直航后台湾游有望降价三成	时政	游戏
陆志明：imf预警世界经济负增长意味着什么	时政	股票
美宇航局第4次推迟发射发现号航天飞机	时政	科技
俞正声：将把世博精神延续到上海今后发展中	时政	家居
蒋孝严赞《建国大业》客观被绿营批评不孝	时政	娱乐
日本机构预测中国2010年gdp或超日4000亿美元	时政	股票
《花花公子》封面推出裸体圣母引众怒(图)	时政	娱乐
奥巴马明日签署经济刺激计划限薪令更加严格	时政	股票
银监会：是否停发第三套房贷由银行自主确定	时政	财经
百千：全民发红包难挽麻生太郎颓势	时政	股票
赵海建：希腊债务危机让世界警醒	时政	股票
香港大学2009年入学奖学金最高达42万	时政	教育
日本h2b大运力火箭首次亮相	时政	科技
证监会暂缓受理开发商重组申请	时政	财经
我国首个火星探测器顺利升空将执行四大任务	时政	科技
李敖观看合璧后富春山居图	时政	家居
美国媒体推出最不靠谱2009年预测	时政	股票
凝眸：法西斯主义复活不是呓语	时政	教育
我国能源供需总体由偏紧转为宽松	时政	财经
我国连续4个月减持美国国债仍是最大债权国	时政	股票
商务部：家电下乡不合格产品不到千分之一	时政	家居
花旗银行摇摇欲坠华尔街再掀危机	时政	股票
大陆80后作者获台湾华文世界电影小说奖首奖	时政	娱乐
央行：民间借贷最高不得超银行利率4倍	时政	财经
欧盟委员会主席巴罗佐：g20峰会须重塑全球化	时政	股票
英国刺猬患皮肤病刺全脱落(图)	时政	科技
我国高校今年新设古生物学等7个专业	时政	教育
郑州供暖企业酝酿暖气涨价遭市民质疑	时政	家居
美国130名议员就人民币汇率施压奥巴马	时政	股票
俄罗斯新版预算案赤字为3万亿卢布	时政	股票
七部委：普通高中将逐步取消择校生	时政	教育
美国男子利用8厘米长眉毛筹集善款	时政	社会
冰岛火山灰可能导致欧洲500架航班取消	时政	股票
一个伦敦银行职员的g20生活	时政	股票
美国财长称不能强迫中国改变汇率	时政	股票
回良玉：减轻不实传言对农产品销售影响	时政	财经
何亮亮：大摩前董事总经理为何东窗事发	时政	财经
俄罗斯紧缩开支应对经济危机	时政	股票
台湾现役士官性侵4名女大学生潜逃14年后被捕	时政	社会
央行高度关注货币政策连续性和稳定性	时政	股票
阿特兰蒂斯号返回地球美30年航天飞机时代终结	时政	科技
教育部首次明确考研舞弊者次年不得再报考	时政	教育
美众议院通过8190亿美元经济刺激方案	时政	股票
纽约时报盘点2008热词：管道工乔堰塞湖等入选	时政	科技
美国救市方案买美国货条款可能引发全球贸易战	时政	股票
陈伟深：欧元区面临欧元解体风险	时政	股票
重庆汽车站绘制非法营运车分布图	时政	社会
调查显示日本近4成夫妻整月无性生活	时政	社会
调查发现男人撒谎多女人谎话质量高	时政	社会
报告称经济危机成美国最大安全威胁	时政	股票
10岁中国男孩成全球最年轻3d动画软件工程师	游戏	社会
独具匠心神奇的后现代乐高积木模型	游戏	科技
叶子猪年度用户有奖调查活动层层好礼	游戏	家居
首部互动微电影集结密令创新与感动	游戏	家居
房祖名李献计与突击风暴约衡山电影院	游戏	娱乐
少年沉迷网游被家人砍手包完绷带还玩	游戏	社会
法国：新旧模式均坚挺产业增长强劲	游戏	股票
德国n!faculty重组，三大主力回归	游戏	家居
dell门店拍照留念赢炫酷音箱时尚挎包	游戏	科技
激活码大放送《绝对火力》（af）微博给力进行时	游戏	体育
陈晓薇离职疑点重重朱骏炒作很成功	游戏	娱乐
男子连续上网1个月玩网游猝死	游戏	社会
冯文杰千尺不只做下载更愿做小红帽	游戏	娱乐
杜绝春捂秋冻褪却衣衫方显春光无限	游戏	家居
少年讲述戒网经历电击令人口吐白沫	游戏	社会
传ipad2行货降价300元起价3688元	游戏	科技
奥特曼不打小怪兽改行做刀削面师傅	游戏	社会
上班“偷菜”浙江31名机关人员被查处	游戏	社会
中国android技术开发大会现场报道	游戏	科技
高桥名人将离职hudson一代传奇离场	游戏	股票
竹内润：日本是欧美厂商最后一块肥肉	游戏	股票
心动点亮感恩教师	游戏	家居
欧买尬、咪兔数位邀你在线团圆庆中秋	游戏	家居
《轻松背单词》教你用记忆魔法记单词	游戏	教育
威尼斯影节众星云集群英赋武将特技	游戏	娱乐
立足产业石景山开启数字娱乐新时代	游戏	家居
东风悦达起亚k2把快乐带向飚车世界	游戏	科技
文化产业获金融支持将使哪些企业受益	游戏	家居
家长监护如药引催化家庭沟通	游戏	家居
零点断网保护未成年人？断源头是根本	游戏	教育
联合国宽带费用支出应低于月收入5％	游戏	股票
设私服非法经营大学生被判侵犯著作权	游戏	社会
升级补完还是敛财换汤不换药的新机型	游戏	科技
网吧一次接纳3名未成年人将吊销牌照	游戏	社会
唐骏携联游入主大华原高管频繁抛售	游戏	财经
洛奇g14s1罗密欧与朱丽叶全新专题	游戏	科技
“家长监护工程”遭遇尴尬申请繁琐	游戏	教育
艺电第三季净亏3.22亿美元将回购6亿股票	游戏	股票
“说出你的爱”博客大赛获奖名单揭晓	游戏	家居
宋在京7月访华阐述上古世纪开发理念	游戏	时政
09年最佳及销量最好iphone应用公布	游戏	科技
《英汉词典随身翻》开始时刻英语学习	游戏	教育
水晶石图书俱乐部交流活动即将盛启	游戏	家居
久游调整研发策略约十余个项目已终止	游戏	股票
《塞尔达》广告宝贝中川翔子重口味写真	游戏	娱乐
组图：“游戏主机化石”出土曝光	游戏	娱乐
雅讯天地获金庸影视作品独家开发版权	游戏	娱乐
white-ra：我喜欢成都女孩子的歌声	游戏	教育
悠嘻猴联手上海银行信用卡俏皮上市	游戏	财经
澳大利亚法院准许病人绝食而终	社会	时政
出海游艇失火13人被及时救出	社会	时政
济南警方捣毁两个贩毒集团抓获百余人(图)	社会	时政
记者亲历北川第一个清明北川学生祭奠师友(图)	社会	教育
沈阳野生动物园老虎伤人原因系责任事故	社会	时政
成都草根剧组与台湾网友合拍《潜伏》续集	社会	娱乐
英国老人将棺材改装成汽车时速达160公里(图)	社会	科技
大陆选手在台湾参加选秀夺冠	社会	时政
内蒙古自治区为现役军人颁发居民身份证(图)	社会	时政
因论文被查出抄袭而出走的北大学生已找到	社会	教育
鲍喜顺身高2.36米重获世界第一高人称号	社会	时政
成都一所中学高三班59名学生20人考上北大清华	社会	教育
李银河：对想嫁富二代的女大学生比较失望	社会	教育
英国52岁清洁工获剑桥荣誉硕士学位(图)	社会	教育
新加坡动物园清洁工被三只白虎咬死(图)	社会	时政
百万飞虫袭击泡桐两小时啃光一棵树(图)	社会	科技
冰封万年猛犸象真身首次在大陆地区展出(图)	社会	科技
陈丹青再批大师文笔差：雨果文章没法读	社会	娱乐
湖南大学8名女硕士集体征婚网名诗情画意(图)	社会	教育
渔民捕获3千斤重大鱼背部可站7条大汉(组图)	社会	科技
香港少年涉嫌发布性爱短片被捕	社会	时政
奥地利一名亿万富翁尸骨失窃	社会	时政
广电总局要求《蜗居》删除涉及乙肝台词	社会	时政
北京工行储户1750万存款丢失案疑犯获死缓	社会	财经
广东博罗县发生恶性斗殴事件1死5伤	社会	时政
标价少写0致14万钻戒卖成1.3万	社会	财经
委内瑞拉动物园蟒蛇吞吃管理员	社会	时政
古树专家治疗1400岁严重虫害毛白杨树(图)	社会	科技
台大学网上办未来事件交易所仿效期货预测选举	社会	时政
印度男女在迪拜传黄色短信被判入狱	社会	时政
涉外中介致25名农民工滞留俄罗斯被查	社会	时政
美国12名政府雇员合买彩票中2.07亿美元	社会	时政
美国9岁血癌女童与7岁男友举行象征性婚礼(图)	社会	教育
武汉吉庆街百名艺人不满管理费太高集体罢演	社会	娱乐
周久耕所抽香烟价格缩水三分之一	社会	时政
摩的司机遭20余人持刀追砍目击居民斥退歹徒	社会	时政
研究称狗可能起源于长江以南地区	社会	科技
吉林发生重大交通事故5人死亡10人受伤	社会	时政
台湾蒙面歹徒打劫金商抢走近8千万新台币	社会	时政
世界最大奶酪蛋糕重达2吨供2万人食用(组图)	社会	科技
百名北京市政协委员参演电影《建国大业》	社会	娱乐
中国工人在俄罗斯杀害同胞被判10年监禁	社会	时政
四川成都万人争抢200岗位求职学生自愿降薪	社会	教育
成吉思汗32代世孙编家谱获国家图书馆收藏	社会	科技
富二代官二代“拼爹”现象引发热议	社会	教育
英国64岁急救员42年拯救11000条人命	社会	时政
70后十大职业薪酬曝光：职业经理人最赚钱	社会	教育
法院为六旬夫妇临时增设周六法庭	社会	时政
奥运冠军龙清泉被湖南大学录取	社会	教育
女评委触摸选手身体香港先生选举被指侮辱男性	社会	娱乐
湖北巴东公安机关对邓玉娇变更为监视居住	社会	时政
男人成功标准改变“经济适用男”脱颖而出	社会	教育
秘鲁44名囚犯抢走看守枪械越狱	社会	时政
鸟巢室外滑雪场昨天下午试营业(图)	社会	时政
台湾网络兴起征求钟点情人拥抱时薪500元台币	社会	时政
广东汕尾渔船私藏9公斤爆炸物被查获	社会	时政
猜猜我是谁：奥运明星童年照片曝光	社会	教育
印度患心理疾病会计师声称劫机致飞机紧急迫降	社会	时政
澳门将举行世界麻将大赛总奖金达100万美元	社会	时政
无牌法拉利高速公路上狂飙时速达220公里	社会	科技
26岁女孩巧用水果酿酒从穷留学生变身总裁	社会	教育
世界最好工作得主获高薪续约坦言工作很累	社会	教育
美一名主持人在节目中坦白与女下属性关系(图)	社会	时政
景德镇展出结石宝宝陶瓷作品(图)	社会	家居
俄罗斯女博士生为写医学论文杀死2名邻居	社会	时政
英国13岁女孩肌肉渐变骨骼将成活雕像(图)	社会	科技
澳大利亚22人被控参与儿童色情网站活动	社会	时政
民企花巨资买下莫桑比克20余处矿区	社会	时政
格鲁吉亚130岁老妇拟申请全球最年长寿星	社会	时政
英国最富水管工欲起诉对手挖客户	社会	时政
苹果售价8800元表面现金色释迦如来像(图)	社会	科技
北理工教授称奥数热原因在于择校热	社会	教育
美国前拳王霍利菲尔德拜访少林请教腿功(图)	社会	时政
恶作剧道具深受青少年追捧	社会	家居
大学开设性教育选修课课堂提问回答千奇百怪	社会	教育
女版小胖走红网络(组图)	社会	家居
千人赴美旅行团展示所购商品称祖国强大腰杆硬	社会	时政
英国学校禁止用红笔批作业以免学生感觉不安	社会	教育
央视男主播经不住追问称女排最喜欢赵蕊蕊	社会	体育
香港小伙南京街头孤身勇斗3名劫匪受伤	社会	时政
海军士官头部受伤勇救17名遇险乘客	社会	时政
参加过台儿庄战役105岁老兵庆祝寿辰	社会	时政
ibm超级电脑人机对战第二场实录	科技	游戏
感受碧蓝海天―雷客青海湖远征队顺利返京	科技	游戏
世界科学节：原来科学也可以很酷	科技	教育
在云端zsoltzsigmond的震撼风光大作	科技	游戏
140头巨头鲸在澳大利亚搁浅死亡(图)	科技	时政
奥林巴斯初体验火热报名让玩家免费试拍	科技	游戏
玛雅世界末日计算方法遭质疑	科技	时政
开源？诺基亚开放symbian系统代码	科技	游戏
文汇报：盘点太空旅游“平民化”路线	科技	教育
俄罗斯欲建功能超欧洲lhc对撞机	科技	时政
各地部落独特审美观磨尖牙拉长耳朵	科技	社会
方舟子：铁强化酱油该不该吃	科技	财经
苹果2011年全球开发者大会未发布iphone五代	科技	游戏
游戏主打娱乐全能本色icool即将上市	科技	游戏
美女如云z酷街舞挑战赛走进中央民大	科技	游戏
英国女“磁人”身体吸金属(图)	科技	教育
研究发现人一天中最具创造力时间在晚上	科技	时政
诺基亚方向成疑symbian3将决定未来	科技	游戏
俄拟实施黑马计划欲在火星卫星建基地(图)	科技	时政
全品参与苏宁易购启动72小时特价专场	科技	家居
美国女子养食蚁兽当宠物与其同睡一张床(图)	科技	社会
美科学网站密切监控12座存在危险火山	科技	时政
科学家揭示做噩梦六大原因	科技	时政
快讯：美国阿特兰蒂斯号航天飞机发射升空	科技	股票
全球厕所大观：北美最高峰冰砖砌成露天厕所	科技	教育
国内掌上游戏机品牌在狭缝中艰难成长	科技	游戏
2010年facebook拆散美国五分之一家庭	科技	游戏
要向网络上新出现的官气说不	科技	游戏
多款重头外设产品亮相2011凯迅行发布会	科技	家居
组图：印度教蛇节给蛇洗牛奶浴	科技	教育
品牌影响力强势提升菲星营销峰会召开	科技	家居
海地地震：科技的失败与伟大	科技	股票
印度拟建世界最低价房：5万人民币即可安居	科技	时政
辉煌六十七年山水再创经典psp游戏机	科技	游戏
冰岛另一火山或将更强喷发	科技	股票
迎双“蛋”南京新世界电玩5折促销	科技	游戏
炫动我心buffalo配件类产品全面上市	科技	游戏
塑料包装疑为塑化剂污染源风险亟待评估	科技	财经
溜溜网超级网购搜索平台上线	科技	游戏
渔民声称拍到尼斯湖怪现身渔场附近(图)	科技	社会
英一战老兵荣升世界最长寿男性现年113岁	科技	社会
我国研制转基因水稻可提炼蛋白质取代献血	科技	时政
美国环保男子实验一年不扔垃圾(图)	科技	社会
英f1车迷天生无左手奔驰捐助义肢准其赛车(图)	科技	体育
星舞我的旅游行程一路吹着“中国风”	科技	游戏
设计师打造概念型扬声器可用来照明	科技	家居
柔性电池：可以用ipad布料作一件t恤	科技	游戏
bbesrslifevibesdnse主流音效介绍	科技	游戏
英国打造便携式人造肺帮助呼吸困难患者	科技	时政
我的艾利和情节艾利和跨年回馈三重奏	科技	游戏
复旦：dna验曹操墓真伪技术上并非难事	科技	教育
央视调查称所谓血燕根本不存在完全系人工制作	科技	时政
男子闯美“探索频道”被击毙：与警方对峙4小时	科技	社会
一切目标在我狙击镜中飞运翔狙击手88	科技	游戏
科学家开发出戒毒疫苗可帮瘾君子摆脱毒瘾	科技	时政
菲星征集品牌卡通形象引发万人关注	科技	家居
俄超级游艇完工造价8亿欧元防御配备堪比战舰	科技	时政
美国92岁双胞胎兄弟同日出生同日死(图)	科技	社会
dvd时代的终结者时代广场数字娱乐业	科技	游戏
美阿特兰蒂斯号航天飞机推迟着陆	科技	时政
印尼海啸伤亡大昂贵预警系统遭质疑	科技	时政
13个关于体重的有趣事实：肥胖可能传染	科技	时政
三名华人教授当选为美国国家科学院院士	科技	时政
转基因稻种曾在汨罗销售：疑已种植多年	科技	社会
十大名贵钻石：南非蓝钻拍出950万美元(图)	科技	财经
全球18座奇特房屋：印度豪华湖上皇宫(组图)	科技	教育
详解核辐射影响人体健康：肠子最易受伤	科技	时政
敢于psp抗衡任天堂ndsl烟台仅850元	科技	游戏
传索尼欲为a系列送葬全幅已成死局	科技	游戏
发现号外部燃料箱阀门出现故障发射再推迟	科技	时政
美成功逆转老鼠衰老过程有助研制长生不老药	科技	时政
不让苹果专美传微软即将推新一代zune	科技	游戏
全球最大思维控制运算中心落户加拿大温哥华	科技	时政
瑞典公司发明奶牛洗澡机产奶量提升3.5%	科技	时政
广州最长寿男人过110岁生日	科技	社会
wcg热潮蔓延三星数码玩飙影像新乐趣	科技	游戏
真正的计算机之父是德国人楚泽	科技	教育
日本3颗随金星探测器升空卫星下落不明(图)	科技	时政
意大利8千斑鸠疑受地球磁北极运动影响死亡	科技	时政
揭秘美国大选电子投票机：可能影响选举结果	科技	时政
二代也未必多么强大ipad2几大破绽分析	科技	游戏
人为何会有口臭：可能是危险疾病信号	科技	时政
一周要闻amdceo离职c版iphone发布	科技	游戏
以色列研制出振动胶囊有助缓解便秘症状(图)	科技	时政
袁幼鸣：还得涨买什么	股票	家居
有色金属：地震波及供给支持近期铜的价格	股票	财经
央行连续三周净投放7天回购利率创2年多新高	股票	财经
玖龙纸业贷款遭逆市加息	股票	财经
中国玉米油ipo发行概况	股票	财经
基金不惧万科融资门冲击巨额融资引发市场动荡	股票	财经
广州冷机：改名东凌粮油翻开新的一页	股票	财经
80大关失守美元仍临两大风险	股票	财经
公告大赛第一赛季冠军头狼入驻滚雪球高手社区	股票	体育
把握吃饭行情27只个股首度晋升基金新贵	股票	财经
哈萨克铜业获国家开发银行15亿美元贷款额度	股票	财经
王亚伟增仓部分几被套牢	股票	财经
新股木薯升势未尽今早再急升35%	股票	财经
有学者提议将澳大模式扩展到整个横琴岛开发	股票	教育
126只qfii持仓股跑赢暴跌市	股票	财经
国美电器非执行董事竺稼先生简介	股票	家居
原油在72美元上方整固	股票	财经
传科威特投资局承诺投资10亿美元aia	股票	时政
沈南鹏的金手指和麦考林带来的晦气	股票	财经
张茉楠：欧元危机谁走谁留	股票	财经
美元重夺避险王位对冲基金积极看多	股票	财经
学者称澳门应优化人口结构素质加强区域竞争力	股票	时政
货币战争笼罩海外市场出口大户布局中国消费	股票	家居
中信国金私有化获通过	股票	财经
北泰复牌须撤清盘呈请	股票	财经
俄铝财政压力不大对铝价后市乐观	股票	财经
外资减持前的三大中资银行股权结构	股票	财经
aia或可纳入各主要指数料触动171亿基金买盘	股票	财经
人民币对外汇期权交易开闸	股票	财经
北美最大招聘网站：美国就业形势将料持续改善	股票	教育
淡水河谷周三登陆香港成香港首例hdr	股票	时政
马涛：g20要在削弱金融霸权上下功夫	股票	时政
俄铝有否发行窝轮存变数	股票	财经
金路集团：期货交易获得批准	股票	财经
人民币对美元连破五关创新高	股票	财经
“lj2288”换仓出击四股收益43.39%	股票	财经
刘鸣炜：华置无供股压力增内地土储	股票	财经
中新地产外债压力之重难承受背水一战押注销售	股票	财经
诺贝尔经济学奖新得主：我无法解决当下混乱	股票	科技
黄金创历史新高白银创30年新高	股票	财经
宝峰澄清郭镇清就销售额的陈述仅为个人意见	股票	娱乐
紫金矿业关停铜矿湿法厂年产铜占13%	股票	财经
小肥羊净利增四成私募欲套现肯德基东家欲接盘	股票	财经
1月险资投资额环比减469.4亿	股票	财经
江淮动力连续暴跌谁忽悠了私募一哥	股票	财经
北京警方证实杜鹃涉经济犯罪	股票	社会
美商务部长：愿与中国政府合作解决贸易争端	股票	时政
国际货币短期无解脱钩美元为正道	股票	财经
基金仓位继续下滑大型基金公司多数减仓	股票	财经
五大银行去年逆势净赚4121亿	股票	财经
基金一季度减仓千亿华夏最凶猛	股票	财经
外汇投资巨亏中信泰富暴跌过五成	股票	财经
高鑫零售交易之前突然叫停	股票	财经
农行不引入境外战投社保基金成唯一赢家	股票	财经
基金狂减地产社保增仓服务业	股票	财经
炒股亏损最多时户均赔7.55万	股票	财经
奥巴马美国经济问题错在布什	股票	时政
肖钢：中银香港力拓港银团业务	股票	财经
商务部称仍未收到腾中收购悍马的任何申请	股票	时政
中投向对冲基金投资数十亿美元	股票	财经
汇贤房托年度预期分派收益率介乎4厘至4.26厘	股票	财经
7月道富投资者信心指数创一年来新高	股票	财经
中移动母公司将在巴基斯坦投资5亿美元	股票	时政
宜科科技创近四年新高军工概念获公私募吸筹	股票	财经
基金抱团选错对象：炭火熄灭医药金融变鸡肋	股票	财经
汇贤产业信托受惠人币升值	股票	财经
非美货币强势带动人民币首破6.54	股票	财经
最坏时刻：过去时还是进行时	股票	财经
天然气供给过多或将拖累油价	股票	财经
米高梅金殿委任5间银行安排香港上	股票	时政
年报投资扭亏高送转有短线机会	股票	财经
黄光裕确认仍未回家哥哥黄俊钦赴国美办公	股票	时政
老八大复兴古井发力三大路径寻找白酒新黑马	股票	体育
央行今发1300亿3月期央票发行规模创纪录	股票	财经
周小川：物价略高于预期货币政策按原计划进行	股票	时政
跟大鳄寻战机抄底四大私募基金重仓股	股票	财经
淡水河谷铁矿石今年大涨170%将迎来首次下调	股票	财经
友邦在亚洲各地区保险市占率一览	股票	财经
美参院越来越业余的五大特征	股票	教育
人民币升值：压力大空间窄	股票	财经
上市公司业绩下滑趋势得到遏制去年分红2385亿	股票	财经
冼博德对渣打表现具信心称资本充裕	股票	财经
27页风险提示创新股之最现代教育成长性堪忧	股票	教育
金融地产成基金二季度增仓重点	股票	财经
夏斌：美联储qe2将导致美元长期贬值	股票	财经
方兴上海港项目累积套现50亿	股票	财经
王亚伟潜伏海南高速猜想：到底有啥概念可挖掘	股票	体育
搜于特：推时尚下乡专注开发三四线市场	股票	家居
g7干预活动将愈加频繁各国正积极储备弹药	股票	时政
裸卖空禁令何以引发连锁反应	股票	财经
保诚邀中投包销供股助购aia	股票	财经
基本面分析：中期油价将下滑	股票	财经
选手yanruzhi2008巧用组合投资收益率超20%	股票	财经
上海复地申请境内发债获批	股票	财经
基金增持47只隐藏重仓股(附表)	股票	财经
原油库存报告在即油价突破65美元	股票	财经
雨润受瘦肉精影响产品金额少于5万元	股票	财经
高手分享：如何四战三捷	股票	教育
物美商业利润净增63%赵丹阳数次加仓分红千万	股票	财经
6券商自营期指套保去年赚逾4亿	股票	财经
中国建材旗下北新建材两纸面石膏板投产	股票	家居
希腊银行工人为死者进行罢工	股票	时政
人民币对美元中间价又创新高	股票	财经
黄金上涨期铜创历史新高	股票	财经
永利澳门遭遇散户临阵撤回申购	股票	财经
8月8日战报：冠军收益翻番转型稳健操作	股票	财经
美克股份：打造家具经典铸就美好生活	股票	家居
社保闪电建仓华孚色纺机构抢筹农业股龙头	股票	财经
彩虹电子附属与深圳虹阳成立合资公司	股票	家居
首季资本项目仍顺差外汇占款压力未减	股票	财经
期现基差放大专家称期指并未领跌大盘	股票	财经
李稻葵：德法尚能自救欧元不会崩溃	股票	财经
农行股票再遇外热内冷：海外基金127亿抢筹h股	股票	财经
方兴获工行45亿元银团授信额度	股票	财经
自由区冠军出击南宁糖业和新华锦	股票	财经
iea预测今年全球原油需求将跌至五年新低	股票	财经
分析师认为中长期油价仍将承压	股票	财经
重视暴跌后的反弹与经验总结	股票	财经
叶檀：全球纸币狂欢资本市场偷欢	股票	财经
3香港7月10日在港推出iphone3gs	股票	游戏
三高一小圈定新兴产业45只高送转潜力股(名单)	股票	教育
油价上涨动力难以维系	股票	财经
中信证券：华夏基金股权转让点评	股票	财经
统一否认将接手汇源	股票	财经
女股神刘央再出击捧三一舍中信	股票	财经
欲斥百亿增持中银香港中行抄底一箭双雕	财经	股票
国际黄金上月涨幅创９年新高	财经	股票
泰坦尼克老年罗丝去世美术馆收藏其画作	财经	时政
曹操墓考古队被指造假挖出来文物是人为预埋	财经	科技
援助难抚恐慌情绪欧元底在何方	财经	股票
15家大行涉嫌助希腊瞒赤字索罗斯领衔唱空欧元	财经	股票
英国新加坡美国加拿大等七国置业攻略(图)	财经	教育
四种方法辨掺白边的红木家具	财经	家居
美联储会议记录压砸美元	财经	股票
景顺长城核心人物流失伤业绩	财经	股票
纽约金价高收2%收复1100美元关口	财经	股票
杰克逊珍藏钢琴将拍卖善款用于青海扶贫工程	财经	时政
胡适陈独秀十年恩怨情仇信札将在嘉德曝光	财经	时政
寻觅四川的敦煌一个社科院研究员的28年坚持	财经	教育
沪拥军优属基金会15年裂变路径	财经	家居
北京三套房贷仍有发放银行称不违反国务院规定	财经	时政
房子这点事儿离婚三成夫妻不抢孩子抢房子	财经	社会
人保送北京消防局百万慰问金央视理赔仍存悬念	财经	体育
明星代言+打包两万亿时代基金营销频出新招	财经	娱乐
高盛事件引发避险情绪美元指数趁势上涨	财经	股票
美激辩otc监管：不重新发明轮子与堵上伦敦漏洞	财经	股票
蒋峰：金融危机可能对世界经济格局有重大影响	财经	时政
以招工为幌收集身份信息骗子办卡百张透支72万	财经	社会
朝鲜将禁止外汇在市面上流通	财经	时政
dailyfx：美元避险地位动摇	财经	股票
开公司急需资金吴宗宪八千万元卖掉豪宅	财经	娱乐
欧债危机或引发流动性短缺欧元成套利交易新宠	财经	股票
焕然一新的奢华详解41米级斐帝星游艇奥德赛	财经	科技
白边红木市场横行投资当心血本无归	财经	家居
香港金管局下调基准利率1个百分点至0.50%	财经	股票
原油黄金疯涨股市大跌	财经	股票
罗杰斯继续看淡美元已开始买进原油期货	财经	股票
再谈香港牛熊证	财经	股票
中国银联与中国联通签署全面战略合作协议	财经	时政
景顺长城ipo询价门忽悠了谁	财经	股票
专家测算平均调整幅度不大	财经	股票
胡润公布2011胡润女富豪榜吴亚军420亿居榜首	财经	时政
香港四富豪身家缩水800亿李嘉诚损失最为惨重	财经	时政
四公司上半年规模排名飙升	财经	股票
英国森林深处惊现巨头雕塑(图)	财经	科技
如何辨别化工壶或代工壶(图)	财经	家居
商品察言观色等待美联储利率决议	财经	股票
美国共同基金期待抄底日本股市	财经	股票
索罗斯赚11亿排名第四	财经	股票
经济复苏推动股指上行	财经	股票
美国一富豪有座吉他豪宅含25座家庭剧院	财经	社会
欧元危机为人民币汇改提供意外机遇	财经	股票
尹朝阳：在欲望中扭曲的正面(图)	财经	娱乐
群雄逐鹿年末发行市场	财经	游戏
科威特主权财富基金去年后三季度损失310亿美元	财经	时政
中国巴菲特但斌否认被打传闻	财经	股票
国务院九大金融举措力促经济发展	财经	时政
事件回放：宝盈风波源于逼宫门	财经	股票
李娜不知道自己赚多少钱用老公信用卡为省钱	财经	娱乐
谢娜张杰大s汪小菲明星蜜月圣地大比拼(图)	财经	家居
老挝红木家具走红中国	财经	家居
信达澳银：以股息率选股	财经	股票
欧佩克连续第八个月下调09年全球原油需求预期	财经	股票
中国有96万千万富豪他们最关注的明星是姜文	财经	娱乐
香港圣诞购物涌现内地富豪1280万港元购名表	财经	时政
摩纳哥展出世上最美钻石(图)	财经	科技
广州地产商投1.2亿元养猪造豪华猪舍全天监控	财经	社会
今年来金鹰旗下产品业绩抢眼	财经	家居
2011年股指市场展望：重心不断升高的秋千	财经	股票
中国近半千万富豪考虑移民14富豪财富源自地产	财经	教育
纽约期铜大跌6.2%收于15个月低点	财经	股票
中国证券报关于金牛奖评选结果声明	财经	时政
赵丹阳餐见巴菲特每分钟吃逾万美元	财经	时政
疲软经济数据突袭油价重挫9%	财经	股票
婚前房产协议重于情感全职太太危机感加重	财经	时政
温家宝总理表示：有信心维护中国金融市场稳定	财经	时政
巴菲特：像我这样的富人交税太少啦	财经	股票
第一财经日报杨宇东：探讨中国式成长驱动力	财经	家居
打新难获高利银行谋打个股	财经	股票
经济复苏一波三折可逢低吸纳美元	财经	股票
俄罗斯贝尔加湖底发现疑似沙皇黄金宝藏(图)	财经	时政
联储大幅降息金价小幅攀升	财经	股票
传券商美女销售员身价超百万比肩首席经济学家	财经	社会
37岁何宝空降博时业界叹太年轻管理能力受关注	财经	社会
债券天王格罗斯：贪婪会卷土重来	财经	股票
马未都称将捐出全部收藏	财经	时政
香港苏富比秋季洋酒拍卖会推出美国藏家珍藏	财经	时政
农行上市暂无明确时间表	财经	股票
最牛的乡村富豪本山大叔生活究竟如何奢华(图)	财经	教育
黄金期货在港上市首日成交合约480张	财经	股票
保卫欧元：7500亿护盘24小时欧盟急需b计划	财经	股票
末路巨头贝尔斯登：翻船的聪明交易者	财经	股票
独家披露蔡铭超拍兽首内幕拍卖前一小时定决心	财经	娱乐
影响全球金融的神秘6岛：中国富豪们的身影	财经	教育
周道炯：始终保护持有人合法权益	财经	家居
美元信心严重受挫基本面能否成救命稻草	财经	股票
买卖红木都是一项风险活	财经	家居
转融通有望年内推出机构股东非限售股进入视野	财经	股票
首套奥运珍邮亮相文博会	财经	家居
银行赴港发债吹起集结号800亿元规模难兑现	财经	股票
避险情绪重来美元大涨告别2009年	财经	股票
刘明达：对冲时代超级大师都可能会被迫清盘	财经	时政
郑交所携手纽约－泛欧交易所	财经	股票
以新思维判断美股与国际油市汇市的关系	财经	股票
纽约黄金期货创八周最高涨幅	财经	股票
工银蓝筹：大消费板块启动中	财经	股票
苏宁电器孙为民：将不遗余力发展网上销售	财经	家居
中信泰富炒汇损失升至186亿港元	财经	股票
鹏华盛世缘何踏空反弹都是营销潜规则惹的祸	财经	家居
景顺长城老总梁华栋去职内幕	财经	游戏
nymex原油期货收跌6.59美元报114.59美元	财经	股票
平安产险开出汶川地震最大保险赔付协议	财经	时政
个人炒黄金亏百万告代理公司违规被驳回	财经	社会
崖柏木真的堪比花梨木吗	财经	家居
